NO textures/basalt.xpm
SO textures/basalt.xpm
WE textures/basalt.xpm
EA textures/basalt.xpm

F 0,255,255
C 225,30,0

1 11
111101
1001
111111
