
EA textures/wood.xpm

C 98,123,123

F 44,219,50

WE textures/red_bricks.xpm

SO textures/red_bricks.xpm
NO textures/grey_stone.xpm
1111
10011
100E1
10001
10001
111111