NO textures/basalt.xpm
SO textures/basalt.xpm
WE textures/basalt.xpm
EA textures/basalt.xpm

F 18,53,25
C 153,204,255

11111
10001
1W101
10001
11111