NO textures/grey_stone.xpm
SO textures/mossy.xpm
WE textures/red_bricks.xpm
EA textures/wood.xpm

F 44,219,50
C 98,214,255

1111111111
1000100001
1000000001
1000N00001
1000000001
1000000001
1111111111
