NO textures/basalt.xpm
SO textures/basalt.xpm
WE textures/basalt.xpm
EA textures/basalt.xpm

F 220,100,0
C 225,30,255

     1111111111
111111N0001
1000000001
1000000001
1000000001
1000000001
1000000001
1000000001
1000000001
1000000001
1000000001
1000000001
1000000001
1000000001
1000000001
1000000001
1000000001
1111111111