NO textures/basalt.xpm
SO textures/basalt.xpm
WE textures/basalt.xpm
EA textures/basalt.xpm

F 220,100,0
C 225,30,255

     1111111111
11111100001
1000000001
1000000001
100S000001
1000000001
1000000001
1000000001
10000000011111111111111111111111
1000000001
1000000001
1000000001
100000001
100000000111111
1000000000000001
100000000111111
1000000001
1111111111