NO textures/basalt.xpm
SO textures/basalt.xpm
WE textures/basalt.xpm
EA textures/basalt.xpm

F 220,100,0
C 225,30,0

     1111111111
11111100001
1000000001
1000000001
1000000001
1000000001
1000000001
1000000001
1000000001
1000000001
1000000001
1000000001
1000000001
1000000001
1000000001
1000000001
1000000001
1111111111