NO textures/grey_stone.xpm
SO textures/mossy.xpm
WE textures/red_bricks.xpm
EA textures/wood.xpm

F 300,219,50
C 98,123,123

111111
100001
10N001
100001
111111