NO textures/grey_stone.xpm
SO textures/mossy.xpm
WE textures/red_bricks.xpm
EA textures/wood.xpm

F 44,219,50

111111
10N001
111111

C 98,123,123