NO textures/grey_stone.xpm
SO textures/mossy.xpm
WE textures/red_bricks.xpm
EA textures/wood.xpm

F 44,219,50
C 98,123,123

11111111
10000001
10N0   1
10000001
11111111