NO textures/grey_stone.xpm
SO textures/mossy.xpm
WE textures/red_bricks.xpm
EA textures/wood.xpm

F 44,219,50
C 98,123,123

111111111111111
100000000000001
101111111111101
100000000000001
101111011111101
100001000000001
101001111110101
10000000N000001
111111111111111